10 20 8 60
####################
#+  #@### DDD    ++#
# # #@@@# ##### ## #
# #####@#  @@ ###  #
#  @@+  # ###D    ##
# ####D## #!#D### @#
#    #D#  # #D#@#  #
#### #D  ## ###@## #
#/DDD#@###@++      #
####################