11 26 8 50
##########################
#/+++#++ #! ++@      @+++#
#D####++ ######      @@++#
#D#  #        #      @@@@#
#@#  DDDDDD   ###        #
#@#    DD     +++ @@@@   #
#   ###   DD       !!    #
# ###!!            DD    #
#      #########         #
#      + + + + +         #
##########################