10 20 8 60
####################
# DDD    +     DDD #
#######      #######
#  #@@#      #@@#! #
#+ @    @D@   ! @ +#
#+      D/D       +#
# #@#   @D@    #@# #
######        ######
# DDD    +     DDD #
####################